A Simple Start
1280 480
17 454
5
5 300 480 300 200 340 200 340 480 300 480
4 200 400 240 300 260 400 200 400
6 100 200 130 180 140 170 150 165 190 168 220 140
5 600 250 800 250 800 350 600 350 600 250
4 1220 420 1230 475 1265 475 1275 420